~~~~~~~~~~~
~.........~
~.........~
~..=====..~
~.........~
~.........~
~~~~~~~~~~~
