~~~~~~~~~
~.......~
~...=...~
~...=...~
~...=...~
~.......~
~~~~~~~~~
