~~~~~~~~~~~~
~..........~
~====..====~
~..........~
~====..====~
~..........~
~~~~~~~~~~~~
