~~~~~~~~~~~~~
~..==.......~
~..==...==..~
~..==...==..~
~..==...==..~
~.......==..~
~~~~~~~~~~~~~
