~~~~~~~~~~~~~
~...........~
~========.==~
~...........~
~==.========~
~...........~
~~~~~~~~~~~~~
